man : мужчина
woman : женщина
child : ребенок
girl : девочка
boy : мальчик
people : человек
mother : мама
father : папа
grandmother : бабушка
grandfather : дедушка
house : дом
apartment : квартира
street : улица
city : город
village : деревня
area : площадь
work : работа
profession : профессия
word : слово
proposal : предложение
phrase : фраза
square : квадрат
circle : руг
triangle : треугольник
rhombus : ромб
cell : клетка
polygon : многоугольник
sun : солнце
moon : луна
sky : небо
cloud : облако
rain : дождь
snow : снег
degrees : град
summer : лето
winter : зима
spring : весна
autumn :осень
wood : дерево
bush : куст
grass : трава
flower : цветок
fetus : плод
berry : ягода
strawberries : клубника
raspberry : малина
pineapple : ананас
watermelon : арбуз
cucumber : огурец
tomato : помидор
apple : яблоко
pear : груша
peach : персик
nature : природа
sea : море
ocean : океан
ice : лёд
river : река
puddle : лужа
mountain : гора
desert : пустыня
travel : путешествие
train : поезд
plane : самолет
boat : катер
bus : автобус
trolleybus : троллейбус
tram : трамвай
car : автомобиль
taxis : такси
bicycle : велосипед
road : дорога
leave : отпуск
luggage : багаж
cargo : груз
entrance : вход
exit : выход
door : дверь
window : окно
wall : стена
floor : пол
ceiling : потолок
balcony : балкон
lamp : лампа
lighting : освещение
carpet : ковер
teacher : учитель
doctor : врач
cleaner : уборщик
builder : строитель
cook : повар
driver : водитель
doctor : доктор
student : студент
pupil : ученик
worker : рабочий
factory : завод
institute : институт
university : университет
school : школа
machine tool : станок
shop : магазин
hospital : больница
plastic : пластик
iron : железо
stone : камень
water : вода
milk : молоко
juice : сок
drink : напиток
kitchen : кухня
potatoes : картофель
pork : свинина
beef : говядина
chicken : курица
turkey : индейка
goose : гусь
duck : утка
bread : хлеб
grain : зерно
flour : мука
oil : масло
bank : банка
plate : тарелка
spoon : ложка
glass : стакан
cup : кружка
bottle : бутылка
saucepan : кастрюля
cooker : плита
refrigerator : холодильник
vase : ваза
table : стол
chair : стул
bed : кровать
chair : кресло
sofa : диван
cupboard : шкаф
stroller : коляска
basket : корзина
bag : умка
choice : выбор
condition : условие
character : характер
respect : уважение
quality : качество
resistance : стойкость
fury : ярость
joy : радость
pride : гордость
anger : злость
exchange : обмен
birth : рождение
beauty : красота
tranquility : спокойствие
selfishness : эгоизм
fear : страх
Friendship : дружба
love : любовь
sadness : грусть
position : положение
generation : поколение
pleasure : удовольствие
height : высота
depth : глубина
hole : дыра
seam : шов
fee : плата
purchase : покупка
letter : письмо
newspaper : газета
Journal : журнал
book : книга
paper : бумага
pen : ручка
pencil : карандаш
brush : кисть
drawing : рисунок
postman : почтальон
leadership : руководство
construction : строительство
protection : покровительство
fan : поклонник
sing : песня
danc : танец
ballet : балет
study : учеба
science : наука
movie : фильм
performance : спектакль
competition : конкурс
cloth : ткань
dress : платье
trousers : брюки
coats : пальто
socks : носки
cardigan : джемпер
gloves : перчатки
blanket : одеяло
pillow : подушка
animal : животное
bird : птица
bear : медведь
elephant : слон
mouse : мышь
cat : кошка
dog : собака
cow : корова
pig : свинья
fish : рыба
frog : лягушка
shark : акула
butterfly : бабочка
dragonfly : стрекоза
spider : паук
snail : улитка
socket : гнездо
burrow : нора
tablet : таблетка
medicine : лекарство
thermometer : градусник
bouquet : букет
gift : подарок
ball : мяч
football : футбол
hockey : хоккей
sports : спорт
stadium : стадион
competition : соревнование
victory : победа
loss : проигрыш
homeland : родина
flag : флаг
news : новость
glory : слава